Guangzhou	广州	guang3 zhou1	Capital city of Guangdong Province.
Shanghai	上海	shang4 hai3	Municipality in Southeast China.
Chongqing	重庆	chong2 qing5	Municipality in Southwest China.
Beijing	北京	bei3 jing1	Capital city of China.
Chengdu	成都	cheng2 du1	Capital city of Sichuan province.
Jinan	济南	ji3 nan2	Capital city of Shandong Province in northeast China.
Shenzhen	深圳	shen1 zhen4	Major city in Guangdong.
Nanjing	南京	nan2 jing1	Capital city of Jiangsu Province, the capital of China in the past.
Harbin	哈尔滨	ha1er3 bin1	Capital of Heilongjiang province.
Qingdao	青岛	qing1 dao3	Subprovincial city in Shangdong.
Changsha	长沙	chang2 sha1	Capital city of Hunan province in south central China.
Zhengzhou	郑州	zheng4 zhou1	Capital city of Henan province.
Nanchang	南昌	nan2 chang1	Capital of Jiangxi Province.
Shijiazhuang	石家庄	shi2 jia1 zhaung1	Capital city of Hebei Province in north China.
Kunming	昆明	kun1 ming2	Capital city of Yunnan Province.
Guangdong	广东	guang3 dong1	Special economic zone close to Hong Kong.
Jiangxi	江西	jiang1 xi1
Hebei	河北	he2 bei3
Yunnan	云南	yun2 nan2
Sichuan	四川	si4 chuan1
Shandong	山东	shan1 dong1
Heilongjiang	黑龙江	hei1 long2 jiang1
Jiangsu	江苏	jiang1 su1
Hunan	湖南	hu2 nan2
Henan	河南	he2 nan2
Cantonese	广东话	guang3 dong1 hua4
Shanghainese	上海话	shang4 hai3 hua4
Taiwan	台湾	tai2 wan1
Hong Kong	香港	xiang1 gang3